10
10
22 22 22 22 22 22 22 22 22 22 
22 0 0 0 0 0 0 0 0 22 
22 0 0 0 0 0 0 0 0 22 
22 0 0 0 0 0 0 0 0 22 
22 0 0 0 0 0 0 0 0 22 
22 0 0 0 0 0 0 0 0 22 
22 0 0 0 0 0 0 0 0 22 
22 0 0 0 0 0 0 0 0 22 
22 0 0 0 0 0 0 0 0 22 
21 21 21 21 21 21 21 21 21 21
