10
10
23,23,23,23,23,23,23,23,23,23,
23,0,0,0,0,0,0,0,0,23,
23,0,0,0,0,0,0,0,0,23,
23,0,0,0,0,0,0,0,0,23,
23,0,0,0,0,0,0,0,0,23,
23,0,0,0,0,0,0,0,0,23,
23,0,0,0,0,0,0,0,0,23,
23,0,0,0,0,0,0,0,0,23,
23,0,0,0,0,0,0,0,0,23,
23,22,22,22,22,22,22,22,22,23
